R 1280 720

NO ./testN.xpm

SO ./testS.xpm

WE ./testW.xpm

EA ./testE.xpm

S ./testSprite.xpm

F 255,255,255

C 255,255,255

111111111111
100000000001
100000000001
100000100001
100000000001
111111111111
