R 1280 720

NO ./testN

SO ./testS

WE ./testW

EA ./testE

S ./testSprite

F 220, 100, 0

C 225, 30, 0

111111111111
100000000001
100000000001
100000000001
100000000001
111111111111
