R 1280 720

NO ./testN.xpm

SO ./testS.xpm

WE ./testW.xpm

EA ./testE.xpm abcd.xpm

S ./testSprite.xpm

F 220,100,255

C 220,100, 255

111111111111
100000000001
100000000001
100000100001
100000000001
111111111111
