R 960 480

NO ./testN.xpm

SO ./testS.xpm

WE ./testW.xpm

EA ./testE.xpm

S ./testSprite.xpm

F 0,0,0

C 0,0,0

        1111111111111111111111111
        10000000001100000S0000001
        1011000001110000002000001
        1001000000000000000000001
111111111011000001110000000000001
100000000011000001110111111111111
11110111111111011100000010001
11110111111111011101010010001
11000000110101011100000010001
10002000000000001100000010001
10000000000000001101010010001
110000011101010111110111100111
11110111 1110101 101111010001
11111111 1111111 111111111111
