R 640 320

NO ./textures/neo_wall.xpm

SO ./textures/neo_wall.xpm

WE ./textures/neo_wall.xpm

EA ./textures/neo_wall.xpm

S ./textures/beauty_squid.xpm

F 178, 102,255

C 0,255,255

11111111111111111111111111111111111              111111111
10000000000000000000000000N00000001              100000001
10000000000000000020000000000000001              100000001
10000000000000000000000000000000001              100000001
10000000000000000000000000000000001              111111111
10000000000000000020000000000000001
100000000000000000000000000002000001
1000000000000111000000000000000000001
1000000000000000002000000000000000001
10000000000000000000000000000000001111111111111
10000000000000000000000000000000001
11111111111111111111111111111111111
11111111
