R 960 480

NO ./textures/red.xpm

SO ./textures/purplestone.xpm

WE ./textures/greystone.xpm

EA ./textures/eagle.xpm

S ./textures/tonneau.xpm

F 0,0,0

C 0,0,0

1111111
1020001
10E2001
1200001
1111111